  PRINTING 96x96 MAP:
	....╔═╦═╦═════╗............................╔═╦═╦╦══╗............................................
	....║.║.║.....║............................║.║.╠╣..║............................................
	....╚═╩═╝.....║............................╠╦╬╦╬╣..║............................................
	..............║............................╠╬╩╩╬╣..║............................................
	.╔═══╗........║..........╔╗................╠╣..╠╣..║............................................
	.║...║........║..........╠╣................╠╩╦═╬╣..║............................................
	.║...║........║..........╠╣................║.║.╠╣..║............................................
	.╚══╦╣........║..........╠╣.╔═════════════╦╬═╩═╩╩══╝............................................
	....╠╣........║..........╠╩╦╝.............╠╣....................................................
	...╔╬╬╦╦╦╗....║.......╔═╦╣.║..............╠╣....................................................
	╔══╩╬╩╩╩╩╝....║.......║.╠╩╦╣..............╠╣.╔╗.................................................
	║...║.........║......╔╩╦╣.╠╣..............╠╣.╠╣.................................................
	╠═╦═╣.........║......║.╠╩╦╩╣..............╠╣.╠╣.................................................
	║.║.║.........║...╔══╩╦╣.║.║..............╠╣.╠╣..........................╔═╗....................
	╠═╬═╣.........║...║...╠╩╦╩╦╝..............╠╣.╠╣..........................║.║....................
	║.║.║.........║...║...║.║.║...............╠╣.╠╩╦═╦╦══════╗...............╠═╣....................
	╠═╬╦╬═╦═╦═╗...║...║...╠═╬═╬═╦═╦═╦═╦═╦═╦╗..╠╣.║.║.╠╣......╚══════════╦═╦═╦╣.║....................
	║.╠╩╣.║.║.║...║...║...║.║.║.║.║.║.║.║.╠╩╦═╩╬═╬═╬═╬╣.................║.║.╠╩╦╣....................
	╠═╣.╠═╬╦╝.║...║...║...╠╦╬╦╩╦╩╦╩╦╩╦╩╦╩╦╣.║..║.║.║.╠╣.................╠═╬═╣.╠╣....................
	║.║.║.╠╣..║...║...╚═══╩╩╩╣.║.║.║.║.║.╠╩╦╣.╔╩╦╩╦╩╦╩╣.................║.║.╠╦╬╣....................
	╠═╣.╠═╬╣..║...║..........╠═╬╦╬╦╩╦╩╦╩╦╣.╠╩╦╣.║.║.║.╠╦╗...............╠═╬═╩╩╬╣....................
	║.║.║.╠╣..║.╔═╝.╔╗.......║.╠╬╩╣.║.║.╠╩╦╣.╠╩╦╩╦╩╦╩╦╩╩╝...............║.║...╠╣....................
	║.║.╠═╬╣..║.║...╠╣.......╠═╬╣.╠═╬═╬═╣.╠╩╦╣.║.║.║.║..................╠═╣...╠╣....................
	║.║.║.╠╣..╠═╬╦═╦╩╣.......║.╠╣.║.║.║.╠═╣.╠╩╦╩╦╩╦╩╦╩╦══╦═╗............║.╠╦╦╦╬╣....................
	║.╠═╬═╬╩╦═╣.╠╣.║.║.......╠═╬╣.╠═╬═╬═╣.╠╦╣.║.║.║.║.║..║.║............╠═╩╩╩╩╩╝....................
	╠═╣.║.║.║.╠═╬╩╦╩╦╣.......║.╠╣.║.║.║.╠═╬╬╩╦╩╦╩╦╩╦╩╦╣..╠═╣............║...........................
	║.╠╦╬╦╩╦╩╦╣.║.║.╠╩══════╦╬╦╬╣.╠═╬╦╬╦╣.╠╣.║.║.║.║.╠╩╗.║.║...╔════════╝...........................
	╠═╬╬╩╣.║.╠╩╦╩╦╩╦╣.......╠╩╩╬╩╦╣.╠╬╩╬╩╦╬╝.╠═╩═╩═╬╦╣.╠═╬═╣...║....................................
	║.╠╣.╠═╬═╣.║.║.╠╣.....╔═╣..║.╠╩╦╩╣.║.╠╣..║.....╚╩╩═╣.║.║...║....................................
	╠═╬╩╦╣.║.╠═╬═╬═╬╣.....║.║..╠═╣.║.╠═╬═╬╩═╦╣.........╠═╬═╣...║....................................
	║.║.╠╩╦╩╦╣.║.║.╠╣...╔╦╬═╬═╦╣.╠═╬═╣.║.║..╠╣.........║.║.║...║....................................
	╠═╬═╣.║.╠╩╦╬═╬═╬╩╦═╦╬╩╣.║.╠╬═╣.║.╠╦╬╦╬═╦╬╬╦╦╦╦╦═╦╗.╠╦╬╦╣...║....................................
	║.║.╠═╬═╣.╠╣.║.║.║.╠╣.╠═╬═╬╣.╠═╬═╬╬╩╩╣.╠╩╩╩╩╩╩╣.╠╣.╚╩╩╩╣...║....................................
	╠═╬═╣.║.╠═╬╩╦╩╦╩╦╩╦╩╬╦╣.║.╠╩╦╣.║.╠╣..╠═╣......╚═╩╩╗....║...║....................................
	║.║.╠═╬═╣.║.║.║.║.║.╠╬╩╦╩╦╣.╠╩╦╩╦╩╬═╦╣.║..........║....║...║....................................
	╠═╬═╣.║.╠═╬═╬═╬═╬═╬═╬╝.║.╠╩╦╣.║.║.║.╠╩╦╣..........║....║...║....╔════╗..........................
	║.║.╠═╬═╣.║.║.║.║.║.║..╠═╣.╠╩╦╬═╩╦╬╦╣.╠╣..........║....║..╔╝....║....║..........................
	╠╦╩═╣.║.╠═╬╦╩╦╩╦╩╦╩╦╩╦═╣.╠═╣.╠╣..╚╩╩╬═╬╣..........║....╚═╦╣.....║....║..........................
	╠╣..╠═╬═╣.╠╣.║.║.║.║.║.╠╦╣.╠═╬╣.....║.╠╣..........║......╠╣.....║....║..........................
	╠╣..║.║.╠═╬╩╦╩╦╩╦╩╦╩╦╩╦╩╬╩═╣.╠╣.....╠═╬╣..........║......╠╣.....║....║..........................
	╠╩╦╦╬╦╩╦╣.║.║.║.║.║.║.║.║..╠╦╩╬═╦═╦═╣.╠╣..........║......╠╣.....║....║..........................
	║.╠╬╩╣.╠╩╦╩╦╩╦╩╦╩╦╩═╩╦╩╦╣..╠╣.║.║.║.╠═╩╣..........║......╠╣.....║....║..........................
	╠═╬╣.╠╦╣.║.║.║.║.║...║.╠╣..╠╣.╚═╩═╩═╣..║..........║.....╔╬╬╦╦╦╦╦╣....║..........................
	║.╠╩╦╩╬╩╦╬╦╬═╬═╬═╣...╚═╬╣..╠╣.......╚══╝..........║.....╠╬╩╩╩╩╩╩╩════╝..........................
	╠╦╣.║.║.╚╩╩╣.║.║.║.....╠╩╦═╬╣.....................║.....╚╝......................................
	╚╩╩╦╩╦╣....╠═╬═╬═╣.....║.║.╠╣.....................║.............................................
	...║.╠╣....║.║.║.║.....╠═╬═╬╣.....................║.............................................
	...╠═╬╣....╠═╬═╬═╣.....║.║.╠╣..........╔═╗........║.............................................
	...║.╠╣....║.║.║.║.....╠═╬═╬╣..........║.╚════════╝.............................................
	...╠═╬╩╦═╦═╬═╬═╬╦╣.....║.║.╠╣..........║........................................................
	...║.║.║.║.║.║.╠╩╣.....╠═╬═╬╣..........║........................................................
	...╠═╬═╩═╬╦╩═╩═╣.║.....║.║.╠╣..........║........................................................
	...║.║...╠╣....║.║.....╠╦╬╦╬╣..........║........................................................
	...╠═╣...╚╝....║.║.....╠╩╩╩╩╝..╔═╗.....║........................................................
	...║.║.........║.╠╦╦╦╦╦╣.......║.╠═╦═══╝........................................................
	...╠═╝.........║.╠╩╩╩╩╬╬╦╦╦╦╦╦╦╩╦╣.║............................................................
	...║...........╠═╣....╠╩╩╩╩╩╩╩╣.╠╩╦╣............................................................
	...║..........╔╣.║....║.......╠═╣.╠╣............................................................
	...║..........╠╬═╝....║.......║.╠╦╬╣............................................................
	...║..........╠╣......║...╔═══╩═╩╩╩╣............................................................
	...║..........╠╣......║...║........║............................................................
	...║........╔╦╬╬╦╦╦╦╦╦╣...║........║............................................................
	...║........╚╩╩╩╩╩╩╩╩╩╩═══╝........║............................................................
	...║...............................║............................................................
	...║...............................║............................................................
	...║...............................║............................................................
	...║...............................║............................................................
	...║...............................║............................................................
	...║...............................║............................................................
	...║...............................║............................................................
	...║...............................║............................................................
	...║...............................║............................................................
	...║...............................║............................................................
	...╚╗..............................║............................................................
	....║..............................║............................................................
	....║............................╔═╝............................................................
	....║............................║..............................................................
	....║............................║..............................................................
	....║..................╔═════════╝..............................................................
	....║..................║........................................................................
	....║..................║........................................................................
	....║..................║........................................................................
	....╚═╗................║........................................................................
	......║................║........................................................................
	......║................║........................................................................
	......║................║........................................................................
	......║................║........................................................................
	......║................║........................................................................
	......║................║........................................................................
	....╔═╝................║........................................................................
	....║..................║........................................................................
	....║..................║........................................................................
	....║..................╚═╗......................................................................
	....╚═══╦═╦═╗............║......╔═════════════╦═╦═╗.............................................
	........║.║.║............║......║.............║.║.║.............................................
	........╚═╩═╝............╚══════╝.............╚═╩═╝.............................................
	